01 01 01 01 01 01 01 01 01 01 01 01 01 01 01 01 01 01 01 01 01 01 01 01 01
01 17 00 01 00 00 00 00 00 06 00 00 00 00 00 00 00 00 00 00 00 00 0e 00 01
01 00 00 01 00 00 00 00 00 00 00 00 00 00 00 00 00 00 04 00 00 00 00 00 01
01 00 00 01 00 00 00 00 00 00 00 00 00 00 00 03 00 00 00 00 00 00 00 00 01
01 00 00 00 0c 00 00 01 00 00 00 00 00 0b 00 00 00 00 00 00 00 00 00 18 01
01 01 01 01 01 00 00 01 01 01 01 01 01 01 01 01 01 01 01 01 01 01 01 01 01
01 00 00 18 01 00 00 00 00 00 00 00 00 00 04 00 00 00 00 00 01 00 00 00 01
01 00 00 00 01 00 00 00 00 00 00 00 00 00 00 00 00 00 00 00 00 00 00 0a 01
01 00 00 00 01 00 00 00 05 00 00 00 00 00 00 00 00 00 00 00 00 00 00 00 01
00 00 00 00 01 00 00 00 00 00 00 00 18 00 00 00 00 03 00 00 01 00 00 00 01
01 00 00 00 01 00 00 00 00 00 00 00 00 00 00 00 00 00 00 00 01 00 06 00 01
01 00 00 00 01 01 01 01 01 01 01 01 01 01 01 01 01 01 01 01 01 00 00 00 01
01 00 00 00 00 00 00 00 00 00 00 00 04 00 00 00 00 00 00 00 00 00 00 00 01
01 00 00 00 05 00 00 00 00 06 00 00 00 00 00 00 00 00 00 00 00 00 00 00 01
01 01 01 01 01 01 01 01 01 01 01 01 01 01 01 01 01 01 01 01 01 01 01 01 01