1 1 5 1 4 1 1 2 1 1 1 1 4 1 4 1 1 1 1 4 4 4 2 1 1 
4 0 0 0 0 0 33 0 0 0 0 0 0 0 0 0 26 0 0 1 0 0 0 1a 1 
1 0 0 0 0 0 1 7 0 0 0 0 0 27 0 0 0 0 0 1 0 0 0 0 1 
1 0 0 0 0 0 1 0 9 0 0 0 0 0 a 0 0 0 0 4 0 0 0 0 1 
1 6 0 0 0 0 1 0 0 24 0 0 0 0 0 0 0 0 0 0 0 0 0 0 4 
1 1 2 1 1 4 1 0 0 1 0 0 0 0 0 13 0 0 0 4 8 20 0 0 1 
0 0 0 0 1 0 0 0 0 0 0 0 0 0 0 0 0 0 0 1 0 0 0 0 1 
1 0 0 0 1 0 0 0 0 0 0 8 0 0 0 0 0 0 0 4 0 0 0 23 1 
1 0 0 0 1 0 e 0 0 0 0 0 0 0 0 0 0 0 0 4 0 0 0 0 4 
1 0 0 0 1 0 0 0 0 0 0 0 0 0 0 0 0 0 36 1 0 0 9 0 1 
1 0 0 0 1 4 1 2 1 1 1 4 4 2 1 1 7 1 4 1 0 0 0 0 1 
1 0 a 0 0 0 0 0 0 0 d 0 0 0 0 0 0 0 0 0 0 0 0 0 1 
4 0 0 0 0 36 0 a 0 0 0 0 8 8 8 0 9 0 0 0 0 0 0 0 1 
1 0 0 0 0 0 20 0 0 0 0 0 0 8 8 0 0 0 0 0 0 0 0 0 1 
4 1 4 1 4 4 1 1 1 1 1 1 1 1 1 1 4 4 1 1 1 1 4 1 1 
