1 4 1 1 1 1 1 1 4 4 1 1 1 1 1 5 1 2 4 1 1 1 4 1 1 
1 0 0 0 0 8 0 0 7 0 0 0 0 1 0 0 0 c 0 0 0 7 0 27 1 
1 0 0 c 0 0 0 0 0 0 0 0 0 1 0 0 0 0 0 0 0 0 0 0 1 
1 0 0 1 1 1 4 1 0 0 20 0 0 1 4 1 1 2 1 1 1 0 0 0 1 
1 0 0 0 0 0 f 1 0 0 0 0 0 0 0 0 0 0 0 0 1 0 0 9 1 
1 1 1 7 1 0 0 1 0 0 a 0 0 0 0 0 7 0 0 0 1 0 0 0 1 
1 e 0 0 1 b 0 1 0 0 1 0 0 1 8 0 0 0 0 23 1 0 0 0 1 
1 0 0 24 0 0 0 1 0 0 1 0 0 1 0 8 8 0 0 0 4 0 a 0 4 
1 1 2 1 4 4 1 1 20 0 1 0 0 1 0 0 0 0 0 0 1 0 0 0 4 
0 0 0 0 0 0 0 1 0 20 1 0 0 1 1 1 1 0 1 2 1 0 0 0 1 
4 0 0 0 0 0 0 1 1 1 1 9 0 4 0 1f 1 0 0 0 7 0 b 0 1 
1 0 0 0 0 20 0 2 0 a 8 0 0 1 0 0 1 1 a 0 0 0 0 0 1 
1 0 0 a 0 0 0 0 0 0 0 0 c 1 0 7 0 1 0 0 9 0 0 0 1 
1 0 0 0 0 0 0 0 0 0 0 8 0 1 0 0 0 0 0 0 0 0 0 1a 1 
1 4 1 1 1 1 1 4 4 1 1 1 4 1 4 1 1 1 4 4 1 1 1 1 1 
