01 01 01 01 01 01 01 01 01 01 01 01 01 01 01 01 01 01 01 01 01 01 01 01 01
01 00 00 00 00 00 00 00 00 00 04 00 00 00 00 00 00 00 00 03 00 00 00 00 01
01 0e 00 00 00 00 00 00 00 00 00 00 00 00 00 00 05 00 00 00 00 00 00 07 01
01 00 00 00 00 00 00 00 00 00 00 01 00 01 01 01 01 01 01 01 01 01 01 01 01
01 00 0c 00 00 00 00 00 00 00 00 01 00 00 00 00 00 05 00 00 00 01 00 00 01
01 01 01 01 01 01 00 04 00 00 00 01 03 00 00 00 00 00 00 00 00 00 00 00 01
00 00 00 00 00 01 00 00 00 00 00 01 00 00 00 00 00 00 05 00 00 01 00 00 01
01 00 00 00 00 01 00 00 00 00 00 01 00 00 00 00 00 00 00 00 18 01 00 00 01
01 00 00 00 18 01 01 01 00 00 0a 01 01 01 01 01 01 01 01 01 01 01 00 04 01
01 00 00 00 00 01 17 00 00 00 00 01 08 00 00 00 05 00 00 00 00 00 00 00 01
01 00 04 00 00 01 00 00 00 00 08 01 00 00 03 00 00 00 04 00 00 00 00 00 01
01 00 00 00 00 01 01 01 01 01 01 01 01 01 01 01 01 01 01 00 00 04 00 00 01
01 00 00 00 00 00 00 00 00 06 00 00 00 00 00 00 00 00 00 00 00 00 00 00 01
01 00 00 00 00 05 00 00 00 00 00 00 00 00 00 00 00 00 00 0b 00 00 00 00 01
01 01 01 01 01 01 01 01 01 01 01 01 01 01 01 01 01 01 01 01 01 01 01 01 01