03 03 03 03 03 03 03 03 03 03 03 03 03 03 03 03 03 03 03 03 03 03 03 03 03 
03 03 03 03 03 03 03 03 03 03 03 03 03 03 03 03 03 03 03 03 03 03 03 03 03 
03 03 03 03 03 03 03 03 03 03 03 03 03 03 03 03 03 03 03 03 03 03 03 03 03 
03 03 03 03 01 01 01 01 04 04 01 01 01 01 01 01 04 01 01 01 01 03 03 03 03
03 03 03 03 01 00 1d 00 00 15 00 00 16 00 00 17 00 00 18 00 01 03 03 03 03
03 03 03 03 01 00 00 00 00 00 00 00 00 00 00 00 00 00 00 00 01 03 03 03 03
03 03 03 03 01 00 00 00 00 00 00 00 00 00 00 00 00 00 00 00 01 03 03 03 03
03 03 03 03 01 00 00 00 00 00 00 00 00 00 00 00 00 00 19 00 04 03 03 03 03
03 03 03 03 04 00 00 00 00 00 00 00 00 00 00 00 00 00 00 00 01 03 03 03 03
03 03 03 03 01 00 00 00 00 00 00 00 00 00 00 00 00 00 1c 00 01 03 03 03 03
03 03 03 03 01 00 1b 00 00 00 00 00 1e 00 00 00 00 00 00 00 01 03 03 03 03
03 03 03 03 01 01 04 04 01 01 01 01 01 01 01 01 04 01 01 01 04 03 03 03 03
03 03 03 03 03 03 03 03 03 03 03 03 03 03 03 03 03 03 03 03 03 03 03 03 03
03 03 03 03 03 03 03 03 03 03 03 03 03 03 03 03 03 03 03 03 03 03 03 03 03 
03 03 03 03 03 03 03 03 03 03 03 03 03 03 03 03 03 03 03 03 03 03 03 03 03 