01 01 05 01 01 01 02 04 01 01 01 01 02 01 01 01 01 01 04 01 01 02 04 01 01
01 26 00 00 00 00 00 0f 0a 00 00 20 00 00 00 24 01 1f 07 01 00 00 00 27 01
01 00 01 01 00 00 00 00 00 20 00 00 00 20 00 00 01 00 00 01 00 00 20 00 01
01 00 01 01 00 01 01 04 04 01 01 01 01 01 01 00 01 07 00 01 00 13 00 00 01
04 00 04 01 08 00 23 00 00 00 00 00 00 00 00 00 01 00 00 01 00 00 00 00 01
04 00 00 00 00 01 01 01 01 01 01 00 01 01 01 00 01 00 07 01 00 00 09 00 01
01 00 01 01 00 01 01 01 00 00 00 00 01 00 00 00 01 00 00 04 00 00 00 00 01
01 00 01 01 00 01 01 01 00 01 01 01 01 00 00 00 01 08 00 01 00 00 00 00 01
01 00 02 01 00 01 0d 00 00 01 01 01 01 00 09 00 01 00 00 01 00 00 00 00 01
01 00 00 00 00 01 0e 01 01 01 01 01 01 00 00 00 01 00 00 00 00 00 00 00 01
01 00 01 01 00 01 02 01 01 01 01 02 01 00 00 00 01 00 00 04 00 08 00 00 04
04 00 04 01 00 00 00 00 00 00 00 00 00 00 00 00 01 0a 00 01 00 00 00 20 04
01 00 01 01 00 01 01 01 01 00 01 01 01 00 0a 00 00 00 00 01 00 00 00 00 01
01 00 00 09 00 00 20 00 00 00 00 00 00 00 00 00 01 00 00 04 00 00 00 00 01
01 04 01 04 01 01 04 01 01 01 01 01 01 04 04 01 01 01 01 01 01 00 01 01 01