01 01 01 01 01 01 01 01 01 01 01 04 01 01 01 01 01 01 01 01 01 05 04 01 01
01 00 1a 04 00 01 0f 00 00 01 20 00 00 00 04 00 01 00 00 00 0a 00 0a 1f 01
04 00 00 01 00 01 23 00 00 00 00 00 00 00 00 00 00 00 00 00 00 00 00 00 01
04 00 00 01 00 00 00 00 00 01 00 00 01 00 00 01 00 00 00 08 00 00 09 00 01
01 00 00 01 00 00 0a 00 00 01 00 00 01 00 00 01 00 00 00 00 00 00 00 00 01
01 00 00 01 00 01 00 00 00 01 00 00 01 00 00 01 00 01 01 01 01 01 04 01 01
01 00 00 00 00 01 0e 00 00 01 0d 00 01 20 00 01 20 01 20 00 09 1f 00 00 01
01 01 01 04 00 01 01 02 01 04 01 04 01 01 02 01 04 01 00 00 07 00 0a 00 01
01 00 07 00 00 00 00 00 00 00 00 00 00 00 00 00 00 09 00 00 00 00 00 00 01
01 00 00 0a 00 00 00 00 00 0a 00 00 00 00 0d 00 00 00 00 00 00 00 00 00 01
01 0d 00 00 24 01 00 00 00 00 00 08 00 00 00 00 00 00 00 07 00 00 00 0d 01
01 04 04 01 01 01 00 00 01 01 01 01 01 04 01 01 02 01 04 01 04 01 01 01 01
01 00 00 00 00 00 00 00 00 00 00 08 00 00 00 00 00 00 09 00 00 00 00 00 01
01 20 0a 00 00 00 00 00 00 09 00 00 00 00 00 00 08 00 00 00 09 00 00 00 01
01 01 01 01 01 01 01 01 01 01 01 01 01 01 01 01 01 01 01 01 01 00 01 01 01