04 01 01 01 04 01 01 04 04 01 01 01 01 01 01 01 04 01 01 01 01 01 04 01 01
01 00 00 00 00 00 00 00 00 00 09 00 00 00 00 00 00 00 00 0a 00 00 20 20 01
01 12 00 00 00 00 00 00 07 00 00 00 00 00 00 00 07 00 00 00 00 00 00 0d 01
01 00 00 00 00 00 00 00 00 00 00 04 00 01 01 02 01 01 01 02 01 01 01 01 01
01 00 25 00 00 00 00 00 00 00 00 01 00 00 00 00 00 08 00 00 00 01 00 00 01
01 01 01 01 02 04 00 08 00 00 00 01 07 00 00 0a 00 00 00 00 00 00 00 00 01
00 00 00 00 00 01 00 00 00 00 00 01 00 00 00 00 00 00 09 00 00 01 00 00 01
01 00 00 00 00 01 00 00 00 00 00 01 00 00 00 00 00 00 00 00 20 01 00 00 01
01 00 00 00 20 01 01 01 00 00 23 01 01 01 01 01 04 01 02 01 01 01 00 00 01
01 00 00 00 00 01 1f 00 00 00 00 01 0e 00 27 00 07 00 00 00 00 00 00 00 04
04 00 0a 00 00 01 00 00 00 00 20 01 00 00 07 00 00 00 08 00 00 00 00 09 01
04 00 00 00 00 01 01 01 01 01 01 02 04 04 01 01 01 01 01 00 00 09 00 00 01
01 00 00 00 00 00 00 00 00 0a 00 00 00 00 00 00 00 00 00 00 00 00 00 00 01
01 00 00 00 00 07 00 00 00 00 00 00 00 00 00 00 00 00 00 24 00 00 00 00 04
01 01 01 01 01 01 01 04 04 01 01 01 01 01 01 01 01 01 01 01 04 01 01 01 01