1 1 1 1 1 1 1 1 1 1 1 1 1 1 1 1 1 1 1 1 1 1 1 1 1 1 1 1 1 1 
1 26 0 0 0 0 0 0 8 0 0 27 0 20 0 0 0 0 0 0 0 0 0 0 0 0 0 0 0 1 
1 0 0 9 0 0 0 0 0 0 7 0 0 0 0 9 0 0 0 0 0 a 0 0 0 0 0 0 0 1 
1 0 1 1 1 1 1 1 1 1 1 0 0 0 0 0 0 0 0 0 0 0 0 0 0 0 0 9 0 1 
1 0 1 0 0 0 0 0 0 0 1 1 1 1 1 1 1 1 1 1 0 0 0 0 0 0 0 0 0 1 
1 0 1 1 0 0 0 0 0 0 0 0 0 0 0 0 0 0 0 1 0 23 0 0 9 0 0 0 0 1 
1 0 0 1 0 0 25 0 0 0 0 0 8 0 0 0 0 0 0 1 0 0 0 0 0 0 0 0 0 1 
1 0 1 1 0 0 0 0 0 0 0 1 1 1 1 0 0 0 0 1 0 0 a 0 0 0 0 9 0 1 
1 0 1 0 0 0 0 0 0 0 0 33 0 12 1 0 a 0 0 1 0 0 0 0 0 9 0 0 0 1 
1 0 1 0 0 0 0 0 0 0 0 33 8 0 1 0 0 0 0 1 0 0 0 0 0 0 0 0 0 1 
1 0 1 1 1 1 1 1 1 1 1 1 1 1 1 0 0 9 0 1 1 1 1 1 1 1 38 39 3a 1 
1 0 0 0 0 0 0 0 0 33 0 0 0 0 0 0 0 0 0 1 20 0 0 0 0 0 0 0 0 1 
1 0 0 0 0 a 0 0 0 33 0 0 0 0 0 9 0 0 0 1 0 0 3c 0 3b 0 3e 0 3d 1 
1 0 0 0 0 0 0 24 0 33 0 0 0 0 0 0 0 0 e 1 0 0 0 0 0 0 0 0 0 1 
1 0 0 0 0 0 0 0 0 33 0 0 0 0 0 0 0 0 0 1 0 0 0 0 0 0 0 0 0 1 
1 1 1 1 1 1 1 1 1 1 1 1 1 1 1 1 1 1 1 1 1 0 1 1 1 1 1 1 1 1 
