1 1 4 1 1 1 4 1 1 1 1 5 1 1 1 1 1 1 4 1 1 1 1 1 1 
1 0 0 0 0 0 0 7 0 0 0 0 0 1 27 0 0 0 0 0 0 0 0 1a 1 
1 0 0 20 0 0 0 0 0 0 0 0 0 1 0 0 0 0 0 0 0 0 0 0 1 
1 0 0 0 23 1 1 2 4 4 1 2 1 4 0 0 0 0 1 0 9 0 0 0 1 
1 0 c 0 0 1 0 0 0 0 0 0 9 0 0 8 8 0 1 0 0 0 0 0 1 
1 0 0 0 0 0 7 0 0 0 b 0 0 0 0 0 0 8 1 0 c 0 0 0 1 
1 0 0 b 0 0 0 0 1 1 2 1 1 4 1 1 1 4 1 0 0 0 c 0 1 
1 0 0 0 0 0 0 1 1 0 0 0 0 b 0 0 0 11 1 0 20 0 0 0 1 
1 1 1 1 0 e 1 1 0 0 0 9 0 0 6 0 0 0 1 0 0 0 0 0 1 
0 0 0 1 2 1 4 0 0 1 1 1 1 1 1 1 7 0 1 0 0 0 0 0 1 
1 0 0 0 0 0 0 0 0 0 a 0 0 0 0 0 0 7 4 2 1 0 0 1 1 
4 0 0 a 0 0 0 0 8 0 0 0 0 c 0 0 0 0 0 0 0 0 0 0 1 
1 0 0 0 0 0 0 8 8 0 0 20 0 0 0 0 0 0 0 0 8 0 0 0 1 
1 0 0 0 0 0 0 0 0 8 0 0 0 0 0 24 0 0 0 0 0 0 0 0 1 
1 4 4 1 1 4 1 1 1 4 1 1 1 1 1 1 1 1 1 1 1 4 1 1 1 
