01 01 02 01 01 01 01 01 01 01 01 01 01 01 01 01 01 01 01 01 01 01 01 01 01
01 1C 00 00 00 00 00 09 06 00 00 00 00 00 00 00 01 17 03 01 0f 00 00 00 01
01 00 01 01 00 00 00 00 00 18 05 18 00 18 00 00 01 00 00 01 00 00 18 00 01
01 00 01 01 00 01 01 01 01 01 01 01 01 01 01 00 01 03 00 01 00 03 00 05 01
01 04 01 01 0a 00 00 00 00 00 00 00 00 00 00 00 01 00 00 01 00 00 00 00 01
01 00 00 00 00 01 01 01 01 01 01 00 01 01 01 00 01 00 03 01 04 00 04 00 01
01 00 01 01 00 01 01 01 00 00 00 00 01 09 00 00 01 00 00 01 00 00 00 00 01
01 00 01 01 00 01 01 01 00 01 01 01 01 00 00 00 01 03 00 01 00 03 00 05 01
01 00 01 01 00 01 07 00 00 01 01 01 01 00 03 00 01 00 00 01 00 00 00 00 01
01 00 00 00 00 01 08 01 01 01 01 01 01 00 00 0b 01 00 00 00 00 00 00 00 01
01 00 01 01 04 01 01 01 01 01 01 01 01 00 00 00 01 00 00 05 00 00 00 00 01
01 00 01 01 00 00 00 00 00 00 00 03 00 00 00 00 01 06 00 01 00 04 00 04 01
01 00 01 01 00 01 01 01 01 00 01 01 01 00 06 00 00 00 00 01 03 00 00 00 01
01 00 00 00 00 00 06 00 00 00 00 00 00 00 00 00 01 00 00 01 00 00 00 00 01
01 01 01 01 01 01 01 01 01 01 01 01 01 01 01 01 01 01 01 01 01 00 01 01 01