1 4 4 1 1 1 1 1 1 4 1 1 1 1 1 1 1 1 1 1 5 1 2 1 1 1 1 1 1 1 
1 0 0 0 0 0 0 0 0 1 0 0 0 0 0 0 0 0 0 0 0 0 0 0 1 0 0 1f 0 1 
1 0 0 0 0 0 1 0 8 1 0 36 0 0 0 0 0 b 0 0 0 a 0 0 1 0 0 0 0 1 
4 0 0 0 0 23 1 10 d 1 0 0 a 0 0 0 0 0 0 0 0 0 0 0 1 0 0 0 0 1 
1 0 c 0 0 0 1 1 1 4 0 0 0 0 0 7 0 0 0 0 0 0 0 0 1 0 0 0 0 1 
1 0 0 0 0 0 0 0 0 1 0 0 0 0 0 0 0 0 0 0 0 0 0 0 1 0 0 7 0 1 
0 0 0 0 0 0 0 0 0 4 33 1 1 1 2 1 4 1 1 1 1 1 1 4 4 0 9 0 0 1 
1 1 2 1 0 0 1 1 1 1 0 a 0 0 0 0 0 0 0 0 0 0 0 0 1 0 0 0 b 1 
1 0 0 0 0 0 0 0 0 1 0 0 0 13 0 0 0 c 8 1 1 1 0 0 1 0 0 0 0 1 
1 0 0 0 a 0 0 0 0 1 0 0 0 0 0 0 0 8 0 0 0 1 0 0 1 b 0 0 0 1 
4 0 8 8 8 0 0 0 0 1 0 0 0 0 0 24 0 0 0 0 0 1 0 36 33 0 0 0 0 1 
4 0 0 8 8 0 0 0 0 1 4 2 1 1 1 1 4 1 1 0 0 1 1 1 1 1 1 1 1 1 
1 0 20 0 8 8 0 0 0 0 0 b 0 0 0 b 0 0 7 27 0 0 0 0 0 0 0 0 0 1 
1 0 0 0 0 0 0 0 0 9 0 0 0 9 0 0 0 0 0 0 0 0 0 0 0 0 0 36 0 1 
1 0 0 0 0 0 0 0 0 0 0 0 0 0 0 0 0 0 0 0 0 0 0 0 0 0 0 0 20 1 
1 1 1 1 4 1 1 1 4 4 1 1 1 1 1 1 4 1 1 1 1 4 1 1 1 1 1 1 1 1 
