1 1 5 1 1 1 2 4 1 1 1 1 2 1 1 1 1 1 4 1 1 2 4 1 1 
1 26 0 0 0 0 0 f a 0 0 20 0 0 0 24 1 1f 7 1 0 0 0 27 1 
1 0 1 1 0 0 0 0 0 20 0 0 0 20 0 0 1 0 0 1 0 0 20 0 1 
1 0 6 1 0 1 1 4 4 1 1 1 1 1 1 0 1 7 0 1 0 13 0 0 1 
4 0 4 1 8 0 23 0 0 0 0 0 0 0 0 0 1 0 0 1 0 0 0 0 1 
4 0 0 0 0 1 1 1 1 1 1 0 1 1 1 0 1 0 7 1 0 0 9 0 1 
1 0 1 1 0 1 1 1 0 0 0 0 1 0 0 0 1 0 0 4 0 0 0 0 1 
1 0 1 1 0 1 1 1 0 1 1 1 1 0 0 0 1 8 0 1 0 8 0 0 1 
1 0 2 1 0 1 d 0 0 1 1 1 1 0 9 0 1 0 0 1 0 0 8 0 1 
1 0 8 0 0 1 e 1 1 1 1 1 1 0 0 0 1 0 0 0 0 8 8 0 1 
1 0 1 1 0 1 2 1 1 1 1 2 1 0 0 0 1 0 0 4 0 8 0 0 4 
4 0 4 1 0 8 8 0 0 0 0 0 0 0 0 0 1 a 0 1 0 0 0 20 4 
1 0 1 1 0 1 1 1 1 0 1 1 1 0 a 0 0 0 0 1 0 0 0 0 1 
1 0 0 9 0 0 20 0 0 0 0 0 0 0 0 0 1 0 0 4 0 0 0 0 1 
1 4 1 4 1 1 4 1 1 1 1 1 1 4 4 1 1 1 1 1 1 0 1 1 1 
