03 03 03 03 03 03 03 03 03 03 03 03 03 03 03 03 03 03 03 03 03 03 03 03 03 03 03 03 03 03 
03 03 03 03 03 03 03 03 03 03 03 03 03 03 03 03 03 03 03 03 03 03 03 03 03 03 03 03 03 03 
03 03 03 03 03 03 03 03 03 03 03 03 03 03 03 03 03 03 03 03 03 03 03 03 03 03 03 03 03 03 
03 03 03 03 03 03 01 01 01 01 04 04 01 01 01 01 01 01 04 01 01 01 01 03 03 03 03 03 03 03 
03 03 03 03 03 03 01 16 1d 15 00 00 00 17 18 19 00 00 1e 00 00 00 01 03 03 03 03 03 03 03 
03 03 03 03 03 03 01 00 00 00 00 00 00 00 00 00 00 00 00 00 00 34 01 03 03 03 03 03 03 03 
03 03 03 03 03 03 01 00 00 00 00 00 00 00 00 00 00 00 00 00 00 35 01 03 03 03 03 03 03 03 
03 03 03 03 03 03 01 00 00 00 00 00 00 00 00 00 00 00 00 00 00 1c 04 03 03 03 03 03 03 03 
03 03 03 03 03 03 04 00 00 00 00 00 00 00 00 00 00 00 00 00 00 00 01 03 03 03 03 03 03 03 
03 03 03 03 03 03 01 00 00 00 00 00 00 00 00 00 00 00 00 00 00 00 01 03 03 03 03 03 03 03 
03 03 03 03 03 03 01 00 1b 00 00 00 00 00 00 00 00 00 00 00 00 00 01 03 03 03 03 03 03 03 
03 03 03 03 03 03 01 01 04 04 01 01 01 01 01 01 01 01 04 01 01 01 04 03 03 03 03 03 03 03 
03 03 03 03 03 03 03 03 03 03 03 03 03 03 03 03 03 03 03 03 03 03 03 03 03 03 03 03 03 03 
03 03 03 03 03 03 03 03 03 03 03 03 03 03 03 03 03 03 03 03 03 03 03 03 03 03 03 03 03 03 
03 03 03 03 03 03 03 03 03 03 03 03 03 03 03 03 03 03 03 03 03 03 03 03 03 03 03 03 03 03 
03 03 03 03 03 03 03 03 03 03 03 03 03 03 03 03 03 03 03 03 03 03 03 03 03 03 03 03 03 03 