4 1 1 1 4 1 1 4 4 1 1 1 1 1 1 1 4 1 1 1 1 1 4 1 1 1 1 1 1 1 
1 0 0 8 0 0 0 0 0 0 b 0 0 0 0 0 0 0 0 a 0 0 20 36 1 0 0 0 0 1 
1 12 0 0 0 8 0 0 7 0 0 0 0 0 0 0 7 0 0 0 0 0 0 d 1 0 0 0 0 1 
1 0 0 0 8 a 0 0 0 0 0 4 0 1 1 2 1 1 1 2 1 1 1 1 1 0 0 0 0 1 
1 0 25 0 0 0 0 0 0 8 0 1 0 0 0 0 0 8 0 0 0 1 0 0 0 0 0 0 0 1 
1 1 1 1 2 4 0 c 8 8 0 1 7 0 0 a 0 0 0 0 0 0 0 0 0 0 0 0 0 1 
0 0 0 0 0 1 0 0 0 c 0 1 0 0 0 0 0 0 9 0 0 1 0 0 0 0 0 0 0 1 
1 0 0 0 0 1 0 0 0 0 0 1 0 0 0 0 0 0 0 0 20 1 0 0 0 0 0 0 0 1 
1 0 0 0 20 1 1 1 0 0 23 1 1 1 1 1 4 1 2 1 1 1 0 0 0 0 0 0 0 1 
1 0 0 0 0 1 1f 0 0 0 0 1 e 0 27 0 7 0 0 0 0 0 0 0 0 0 0 0 0 1 
4 0 a 0 0 1 0 0 0 0 36 1 0 0 7 0 0 0 8 0 0 0 0 b 0 0 0 0 0 1 
4 0 0 0 0 1 1 1 1 1 1 2 4 4 1 1 1 1 1 0 0 9 0 0 0 0 0 0 0 1 
1 0 0 c 0 0 0 0 0 a 0 0 9 0 0 0 0 0 0 0 0 0 0 0 0 0 0 0 0 1 
1 0 0 0 0 7 0 0 0 0 0 0 0 0 0 b 0 0 0 24 0 0 0 0 0 0 0 0 0 1 
1 0 0 0 0 0 0 0 0 0 0 0 0 0 0 0 0 0 0 0 0 0 0 0 0 0 0 0 0 1 
1 1 1 1 1 1 1 4 4 1 1 1 1 1 1 1 1 1 1 1 4 1 1 1 1 1 1 1 1 1 
