01 01 01 01 01 01 01 01 01 01 01 01 01 01 01 01 16 16 16 16 16 16 16 16 16
01 00 00 10 00 00 11 00 00 12 00 00 13 00 00 01 16 16 16 16 16 16 16 16 16
01 00 00 00 00 00 00 00 00 00 00 00 00 00 00 01 16 16 16 16 16 16 16 16 16
01 00 00 00 00 00 00 00 00 00 00 00 00 00 00 01 16 16 16 16 16 16 16 16 16
01 00 00 00 00 00 00 00 00 00 00 00 14 00 00 01 16 16 16 16 16 16 16 16 16
01 00 00 00 00 00 00 00 00 00 00 00 00 00 00 01 16 16 16 16 16 16 16 16 16
01 00 00 00 00 00 00 00 00 00 00 00 00 00 00 01 16 16 16 16 16 16 16 16 16
01 00 00 00 00 00 00 00 00 00 00 00 00 00 00 01 16 16 16 16 16 16 16 16 16
01 01 01 01 01 01 01 01 01 01 01 01 01 01 01 01 16 16 16 16 16 16 16 16 16
16 16 16 16 16 16 16 16 16 16 16 16 16 16 16 16 16 16 16 16 16 16 16 16 16
16 16 16 16 16 16 16 16 16 16 16 16 16 16 16 16 16 16 16 16 16 16 16 16 16
16 16 16 16 16 16 16 16 16 16 16 16 16 16 16 16 16 16 16 16 16 16 16 16 16
16 16 16 16 16 16 16 16 16 16 16 16 16 16 16 16 16 16 16 16 16 16 16 16 16
16 16 16 16 16 16 16 16 16 16 16 16 16 16 16 16 16 16 16 16 16 16 16 16 16
16 16 16 16 16 16 16 16 16 16 16 16 16 16 16 16 16 16 16 16 16 16 16 16 16