01 01 01 01 01 01 01 01 01 01 01 01 01 01 01 01 01 01 01 01 01 02 01 01 01
01 00 15 01 00 01 09 00 00 01 18 00 00 00 01 00 01 00 00 00 06 00 06 17 01
01 00 00 01 00 01 0a 00 00 00 00 00 00 00 00 00 00 00 00 00 00 00 05 00 01
01 00 00 01 00 00 00 00 00 01 00 00 01 00 00 01 00 00 00 04 00 00 03 00 01
01 00 00 01 00 00 06 00 00 01 00 00 01 00 00 01 00 00 00 00 00 00 00 00 01
01 00 00 01 00 01 00 00 00 01 00 00 01 00 00 01 00 01 01 01 01 01 01 01 01
01 00 00 00 00 01 08 00 00 01 07 00 01 18 00 01 18 01 04 00 00 17 08 00 01
01 01 01 01 00 01 01 01 01 01 01 01 01 01 01 01 01 01 00 00 03 00 06 00 01
01 00 03 00 00 00 00 00 00 00 00 00 00 00 00 00 00 04 00 00 00 00 00 00 01
01 00 00 06 00 00 00 00 00 06 00 00 00 00 03 00 00 00 00 00 00 05 00 00 01
01 07 00 00 0b 01 00 00 00 00 00 05 00 00 00 00 00 00 00 05 00 00 04 07 01
01 01 01 01 01 01 00 00 01 01 01 01 01 01 01 01 01 01 01 01 01 01 01 01 01
01 00 00 00 00 00 00 00 00 00 00 04 00 00 00 00 00 00 05 00 00 00 00 00 01
01 18 06 00 00 00 00 00 00 04 00 00 00 00 00 00 05 00 00 00 05 00 00 00 01
01 01 01 01 01 01 01 01 01 01 01 01 01 01 01 01 01 01 01 01 01 00 01 01 01