01 01 01 01 01 01 01 01 01 01 01 01 01 01 01 01 01 01 01 01 01 02 01 01 01
01 00 00 00 00 00 00 00 00 00 00 00 00 00 00 00 00 00 00 00 00 00 00 0f 01
01 00 00 00 00 00 00 00 00 00 00 00 00 05 00 00 00 00 03 00 00 00 00 00 01
01 00 00 00 05 00 00 00 00 01 00 00 00 00 00 00 00 00 00 00 00 00 00 00 01
01 00 00 00 00 00 00 00 0a 01 00 00 00 00 00 00 00 00 00 00 00 00 00 00 01
01 00 00 00 00 00 06 00 00 01 00 00 18 00 00 00 00 01 01 01 01 01 01 01 01
01 00 00 00 00 00 00 00 00 01 00 00 00 00 00 00 00 01 00 00 00 17 00 00 01
01 00 00 00 00 01 01 01 01 01 01 01 01 01 01 01 01 01 00 00 00 00 00 00 01
01 00 03 00 00 00 00 00 00 00 00 00 00 00 00 00 00 04 00 00 00 00 00 00 01
01 00 00 00 00 00 00 00 00 00 00 00 00 00 03 00 00 00 00 00 00 00 00 00 01
01 00 00 00 00 01 00 00 00 00 00 00 00 00 00 00 0b 00 00 05 00 00 00 00 01
01 01 01 01 01 01 00 00 01 01 01 01 01 01 01 01 01 01 01 01 01 01 01 01 01
01 00 00 00 00 00 00 00 00 00 00 04 00 00 00 00 00 00 00 00 00 00 00 00 01
01 18 00 00 00 00 00 00 00 00 00 00 00 00 04 00 00 00 00 00 00 00 00 00 01
01 01 01 01 01 01 01 01 01 01 01 01 01 01 01 01 01 01 01 01 01 00 01 01 01