01 01 04 01 01 01 04 01 01 01 01 05 01 01 01 01 01 01 04 01 01 01 01 01 01
01 00 00 00 00 00 00 07 00 00 00 00 00 01 00 00 00 00 00 00 00 00 00 1a 01
01 00 00 20 00 00 00 00 00 00 00 00 00 01 00 00 00 00 00 00 00 00 00 00 01
01 00 00 00 23 01 01 02 04 04 01 02 01 04 00 00 00 00 01 00 09 00 00 00 01
01 00 00 00 00 01 00 00 00 00 00 00 00 00 00 08 00 00 01 00 00 00 00 00 01
01 00 00 00 00 00 07 00 00 00 00 00 00 00 00 00 00 00 01 00 00 00 00 00 01
01 00 00 09 00 00 00 00 01 01 02 01 01 04 01 01 01 04 01 00 00 00 09 00 01
01 00 00 00 00 00 00 01 01 00 00 00 00 00 00 00 00 00 01 00 20 00 00 00 01
01 01 01 01 00 0e 01 01 00 00 00 00 00 00 00 00 00 00 01 00 00 00 00 00 01
00 00 00 01 02 01 04 00 00 00 00 00 00 00 00 01 07 00 01 00 00 00 00 00 01
01 00 00 00 00 00 00 00 00 00 0a 00 00 00 00 00 00 07 04 02 01 00 00 01 01
04 00 00 0a 00 00 00 00 00 00 00 00 00 00 00 00 00 00 00 00 00 00 00 00 01
01 00 00 00 00 00 00 08 00 00 00 20 00 00 00 00 00 00 00 00 08 00 00 00 01
01 00 00 00 00 00 00 00 00 00 00 00 00 00 00 24 00 00 00 00 00 00 00 00 01
01 04 04 01 01 04 01 01 01 04 01 01 01 01 01 01 01 01 01 01 01 04 01 01 01