1 5 1 1 1 1 2 4 1 1 1 1 2 1 1 1 1 1 4 1 1 2 4 1 1 1 1 4 5 1 
1 0 1 26 0 0 27 0 0 0 0 1 0 0 0 8 0 0 0 9 0 0 0 d d d 0 1 0 1 
1 21 1 0 1 0 0 0 0 0 a 1 a 0 0 0 0 b 0 7 0 1 0 0 0 0 0 1 0 1 
1 0 1 20 1 0 0 0 a 0 0 1 0 2a 0 8 0 0 0 9 0 1 8 8 8 8 8 1 0 1 
4 0 1 0 1 0 a 0 0 0 0 1 0 24 0 0 0 b 0 0 0 1 23 0 0 0 0 1 0 1 
4 d 1 20 1 0 0 0 0 a 0 1 0 0 0 8 0 0 0 9 0 1 7 0 7 0 7 1 0 1 
1 0 1 0 1 0 0 a 0 0 0 1 0 7 0 0 0 b 0 0 7 1 0 0 a 0 0 1 0 1 
1 0 1 20 1 a 0 0 0 0 a 1 0 0 0 8 0 0 0 9 0 1 0 7 0 7 0 1 0 1 
1 e 1 0 1 0 0 0 a 0 0 1 0 0 0 0 0 b 0 0 0 1 9 0 0 0 0 1 0 1 
1 0 1 20 1 0 a 0 0 0 0 1 0 7 0 8 0 0 0 9 0 1 7 0 7 0 7 1 0 1 
1 0 1 0 1 0 0 0 c 0 0 1 0 0 a 0 1 1 33 1 2 1 0 0 0 0 b 1 0 1 
4 10 1 20 1 0 0 0 0 c 0 1 0 0 0 0 1 0 0 1 0 0 0 7 0 7 0 1 0 4 
1 0 1 0 1 0 0 0 0 0 c 1 0 29 1 1 2 0 0 1 0 0 0 0 0 0 0 1 0 1 
1 0 1 20 1 0 4 4 4 4 4 1 1 1 1 f 0 0 0 1 0 22 2 1 1 1 2 1 0 1 
1 36 36 36 1 0 33 33 33 33 33 33 33 33 33 0 0 e e 1 0 0 0 0 0 0 0 0 0 1 
1 4 1 4 1 1 4 1 1 1 1 1 1 4 4 1 1 1 1 1 1 0 1 1 1 1 1 1 1 1 
