01 01 01 01 01 01 01 01 01 01 01 01 01 01 01 01 01 01 01 01 01 01 01 01 01
01 27 00 00 00 00 00 00 08 00 00 00 00 20 00 00 00 00 00 00 00 00 00 00 01
01 00 00 00 00 00 00 00 00 00 07 00 00 00 00 09 00 00 00 00 00 0a 00 00 01
01 00 09 00 00 00 08 00 00 00 00 00 00 00 00 00 00 00 00 00 00 00 00 00 01
01 00 00 00 01 01 01 01 01 01 01 01 01 01 01 01 01 01 01 01 00 00 00 00 01
01 00 00 00 01 00 00 00 00 00 00 00 00 00 00 00 00 00 00 01 00 23 00 00 01
01 00 00 00 01 25 00 00 00 00 00 00 08 00 00 00 00 00 00 01 00 00 00 00 01
01 00 09 00 01 00 00 00 01 01 01 01 01 01 01 00 00 00 00 01 00 00 0a 00 01
01 00 00 00 01 00 00 00 00 00 00 00 00 12 01 00 0a 00 00 01 00 00 00 00 01
01 09 00 00 01 00 00 00 00 00 00 00 08 00 01 00 00 00 00 01 00 00 00 00 01
01 00 00 00 01 01 01 01 01 01 01 01 01 01 01 00 00 09 00 01 01 01 01 00 01
01 00 00 00 00 00 00 00 00 00 00 00 00 00 00 00 00 00 00 01 20 00 00 00 01
01 00 00 00 00 0a 00 00 00 00 00 00 00 00 00 09 00 00 00 01 00 00 00 00 01
01 00 00 00 00 00 00 24 00 00 00 00 00 00 00 00 00 00 0e 01 00 00 00 00 01
01 01 01 01 01 01 01 01 01 01 01 01 01 01 01 01 01 01 01 01 01 00 01 01 01