01 01 02 01 01 01 01 01 01 01 01 01 01 01 01 01 01 01 01 01 01 01 01 01 01
01 00 00 00 00 00 00 00 00 00 00 00 00 00 00 00 00 1C 00 01 00 00 00 0f 01
01 00 00 00 00 00 00 03 00 00 00 00 00 00 00 00 00 00 00 01 00 00 00 00 01
01 00 00 00 00 00 01 00 05 00 00 00 00 00 06 00 00 00 00 01 00 00 00 00 01
01 00 00 00 00 00 01 00 00 00 00 00 00 00 00 00 00 00 00 00 00 00 00 00 01
01 01 01 01 01 01 01 00 00 01 00 05 00 00 00 00 00 00 00 01 00 04 00 00 01
00 00 00 00 01 00 00 00 00 00 00 00 00 00 00 00 00 00 00 01 00 00 00 00 01
01 00 00 00 01 00 00 00 00 00 00 00 00 00 00 00 00 00 00 01 00 00 00 00 01
01 00 00 00 01 00 08 00 00 00 04 00 00 00 00 00 00 00 00 01 00 00 00 00 01
01 00 00 00 01 00 00 00 00 00 00 00 00 00 00 00 00 00 18 01 00 00 00 00 01
01 00 00 00 01 01 01 01 01 01 01 01 01 01 01 01 01 01 01 01 00 00 04 00 01
01 00 06 00 00 00 00 00 00 00 03 00 00 00 00 00 00 00 00 00 00 00 00 00 01
01 00 00 00 00 00 00 05 00 00 00 00 00 00 00 04 00 00 00 00 00 00 00 00 01
01 00 00 00 00 00 18 00 00 00 00 00 00 00 00 00 00 00 00 00 00 00 00 00 01
01 01 01 01 01 01 01 01 01 01 01 01 01 01 01 01 01 01 01 01 01 01 01 01 01