01 01 01 04 01 01 01 04 04 01 01 01 01 01 04 01 01 01 02 01 04 01 01 01 01
01 1f 00 01 00 00 00 00 00 07 00 00 00 00 00 00 00 00 00 00 00 00 12 00 01
01 00 00 01 00 00 00 00 00 00 00 00 00 00 00 00 00 00 09 00 00 00 00 00 01
01 00 00 02 00 00 00 00 00 00 00 00 00 00 00 08 00 00 00 00 00 00 00 00 01
01 00 00 00 25 00 00 01 00 00 00 00 00 24 00 00 00 00 00 00 00 00 00 20 01
04 01 01 01 04 00 00 01 01 01 04 02 01 01 01 01 01 01 01 04 01 01 01 04 04
01 00 00 20 04 00 00 00 00 00 00 00 00 00 00 00 00 00 00 00 01 00 00 00 01
01 00 00 00 01 00 00 00 00 00 00 00 00 00 07 00 00 00 00 00 00 00 00 23 01
04 00 00 00 01 00 00 00 0a 00 00 00 00 00 00 00 00 00 00 00 00 00 00 00 01
00 00 00 00 01 00 00 00 00 00 00 00 20 09 00 00 00 09 00 00 01 00 00 00 01
01 00 00 00 01 00 00 00 00 00 00 00 00 00 00 00 00 00 00 00 01 00 0a 00 01
01 00 00 00 01 01 02 01 01 01 04 01 02 01 01 01 01 01 01 04 01 00 00 00 01
01 00 00 00 00 00 00 00 00 00 00 00 0e 00 00 00 00 00 00 00 00 00 00 00 01
04 00 00 00 0f 00 00 00 00 0a 00 00 00 00 00 00 00 00 00 00 00 00 00 00 01
01 01 01 04 01 04 04 01 01 01 01 01 01 04 01 01 01 01 01 04 01 01 01 01 01