1 1 1 1 1 1 1 1 1 1 1 4 1 1 1 1 1 1 1 1 1 5 4 1 1 
1 0 1a 4 0 1 f 0 0 1 20 0 0 0 4 0 1 0 0 0 a 0 a 1f 1 
4 0 0 1 0 1 23 0 0 0 0 0 0 0 0 0 0 0 0 0 0 0 0 0 1 
4 0 0 1 0 0 0 0 0 1 0 0 1 0 0 1 0 0 0 8 0 0 9 0 1 
1 0 0 1 0 0 a 0 0 1 0 0 1 0 0 1 0 0 0 0 0 0 0 0 1 
1 0 0 1 0 1 0 0 0 1 0 0 1 0 0 1 0 1 1 1 1 1 4 1 1 
1 0 0 0 0 1 e 0 0 1 d 0 1 20 0 1 20 1 20 0 9 1f 0 0 1 
1 1 1 4 0 1 1 2 1 4 1 4 1 1 2 1 4 1 0 0 7 0 a 0 1 
1 0 7 0 0 0 0 0 0 0 0 0 0 0 0 0 0 9 0 0 0 0 0 0 1 
1 0 0 a 0 0 0 0 0 a 0 0 0 0 d 0 0 0 0 0 0 0 0 0 1 
1 d 0 0 24 1 0 0 0 0 0 8 0 0 0 0 0 0 0 7 0 0 0 d 1 
1 4 4 1 1 1 0 0 1 1 1 1 1 4 1 1 2 1 4 1 4 1 1 1 1 
1 0 0 0 0 0 0 0 0 0 0 8 0 0 0 0 0 0 9 0 0 0 0 0 1 
1 6 a 0 0 0 0 0 0 9 0 0 0 0 0 0 8 0 0 0 9 0 0 0 1 
1 1 1 1 1 1 1 1 1 1 1 1 1 1 1 1 1 1 1 1 1 0 1 1 1 
