1 1 1 4 1 1 1 4 4 1 1 1 1 1 4 1 1 1 2 1 4 1 1 1 1 
1 1f 0 1 0 0 0 0 0 7 0 0 0 0 8 0 0 0 0 0 0 0 12 0 1 
1 0 0 1 0 0 0 0 0 0 0 0 a 0 0 0 8 0 c 0 0 0 0 0 1 
1 7 0 2 0 0 0 0 0 9 0 0 0 0 0 c 0 8 0 0 0 0 0 0 1 
1 0 0 0 25 0 0 1 0 0 0 0 0 24 0 0 0 0 0 0 0 0 0 20 1 
4 1 1 1 4 0 0 1 1 1 4 2 1 1 1 1 1 1 1 4 1 1 1 4 4 
1 0 0 20 4 0 0 0 0 0 0 0 0 0 0 1 0 0 0 0 1 0 0 0 1 
1 0 0 0 1 0 b 0 0 0 0 0 4 0 7 0 0 0 0 0 0 0 0 23 1 
4 0 0 0 1 0 0 0 a 0 0 0 0 0 0 1 0 0 0 0 0 0 0 0 1 
0 0 0 0 1 0 0 0 0 0 0 0 20 b 0 1 1 9 0 0 1 0 0 0 1 
1 0 0 0 1 0 0 0 0 0 0 0 0 0 0 0 0 0 0 0 1 0 a 0 1 
1 0 9 0 1 1 2 1 1 1 4 1 2 1 1 1 1 1 1 4 1 0 0 0 1 
1 0 0 0 0 0 0 8 0 0 0 0 e 0 0 0 0 0 0 8 8 7 0 0 1 
4 0 0 0 c 8 0 0 0 a 0 0 0 0 7 0 0 8 0 0 0 0 0 8 1 
1 1 1 4 1 4 4 1 1 1 1 1 1 4 1 1 1 1 1 4 1 1 1 1 1 
