1 1 1 1 1 1 1 1 1 1 1 1 1 1 1 1 1 1 1 1 1 1 1 1 1 
1 27 0 0 0 0 0 0 8 0 0 0 0 20 0 0 0 0 0 0 0 0 0 0 1 
1 0 0 0 0 0 0 0 0 0 7 0 0 0 0 9 0 0 0 0 0 a 0 0 1 
1 0 9 0 0 0 8 0 0 0 0 0 0 0 0 0 0 0 0 0 0 0 0 0 1 
1 0 0 0 1 1 1 1 1 1 1 1 1 1 1 1 1 1 1 1 0 0 0 0 1 
1 0 0 0 1 0 0 0 0 0 0 0 0 0 0 0 0 0 0 1 0 23 0 0 1 
1 0 0 0 1 25 0 0 0 0 0 0 8 0 0 0 0 0 0 1 0 0 0 0 1 
1 0 9 0 1 0 0 0 1 1 1 1 1 1 1 0 0 0 0 1 0 0 a 0 1 
1 0 0 0 1 0 0 0 0 0 0 0 0 12 1 0 a 0 0 1 0 0 0 0 1 
1 9 0 0 1 0 0 0 0 0 0 0 8 0 1 0 0 0 0 1 0 0 0 0 1 
1 0 0 0 1 1 1 1 1 1 1 1 1 1 1 0 0 9 0 1 1 1 1 0 1 
1 0 0 0 0 0 0 0 0 0 0 0 0 0 0 0 0 0 0 1 20 0 0 0 1 
1 0 0 0 0 a 0 0 0 0 0 0 0 0 0 9 0 0 0 1 0 0 0 0 1 
1 0 0 0 0 0 0 24 0 0 0 0 0 0 0 0 0 0 e 1 0 0 0 0 1 
1 1 1 1 1 1 1 1 1 1 1 1 1 1 1 1 1 1 1 1 1 0 1 1 1 
